"REF"	"character"
"PTT"	"numeric"
"END_DATE"	"POSIXct"
"MAX_DBAR"	"numeric"
"CNT"	"numeric"
"NUM"	"numeric"
"N_TEMP"	"integer"
"N_PHOTO"	"integer"
"TEMP_DBAR"	"character"
"TEMP_VALS"	"character"
"N_COND"	"integer"
"COND_DBAR"	"character"
"COND_VALS"	"character"
"N_SAL"	"integer"
"SAL_DBAR"	"character"
"SAL_VALS"	"character"
"N_FLUORO"	"integer"
"FLUORO_DBAR"	"character"
"FLUORO_VALS"	"character"
"N_OXY"	"integer"
"OXY_DBAR"	"character"
"OXY_VALS"	"character"
"PHOTO_DBAR"	"character"
"PHOTO_VALS"	"character"
"QC_PROFILE"	"integer"
"QC_TEMP"	"character"
"QC_SAL"	"character"
"SAL_CORRECTED_VALS"	"character"
"CREATED"	"POSIXct"
"MODIFIED"	"POSIXct"
"LON"	"numeric"
"LAT"	"numeric"
