"REF"	"character"
"PTT"	"numeric"
"BODY"	"numeric"
"ON_DATE"	"Date"
"OFF_DATE"	"Date"
"TEST_DATE"	"POSIXct"
"SPECIES"	"character"
"LOCATION"	"character"
"GREF"	"character"
"NAME"	"character"
"YEAR"	"integer"
"HOME_LAT"	"numeric"
"HOME_LON"	"numeric"
"VMASK_THRESHOLD"	"integer"
"PROG"	"character"
"PARMS"	"character"
"DIVE_THRESHOLD"	"logical"
"COMMENTS"	"character"
"N_PTTS"	"integer"
"T_OFFSET"	"numeric"
"T_SCALE"	"numeric"
"RECOVERED"	"character"
"WMO"	"integer"
"SAL_CORRECTION"	"numeric"
"CREATED"	"POSIXct"
"MODIFIED"	"POSIXct"
"TDR"	"character"
"LOC_TYPE"	"character"
"TX_MODE"	"character"
