"REF"	"character"
"PTT"	"numeric"
"U_DATE"	"POSIXct"
"TX_NUMBER"	"integer"
"OCLOCK"	"character"
"TAG_TIME"	"character"
"MAX_DEPTH"	"numeric"
"ABORTED_TX"	"integer"
"BODY"	"integer"
"LATEST_RESET"	"character"
"N_RESETS"	"integer"
"ADC_OFFSET"	"integer"
"WD_STATUS"	"integer"
"N_WD_FAIL"	"integer"
"N_ODO_FAIL"	"integer"
"DRY_COND"	"integer"
"WET_COND"	"integer"
"GPS_NONE"	"integer"
"GPS_SUB5"	"integer"
"GPS_GOOD"	"integer"
"GPS_REBOOT"	"integer"
"TEMPERATURE"	"numeric"
"ODOMETER"	"numeric"
"BATTERY_MV"	"integer"
"HOURLY_TX_ALLOWANCE"	"integer"
"DEPTH_SPIKES"	"integer"
"CTD_SAMPLES"	"integer"
"VMT_DETRECS"	"numeric"
"VMT_NRESETS"	"numeric"
"VMT_MEMPTR"	"numeric"
"VMT_PULSES"	"numeric"
"VMT_SYNCH"	"numeric"
"VMT_REJECTS"	"numeric"
"VMT_PARTIALS"	"numeric"
"VMT_DTG"	"numeric"
"VMT_TIME"	"POSIXct"
"VMT_DMEM"	"numeric"
"VMT_TDECT"	"numeric"
"VMT_PCOUNT"	"numeric"
"VMT_NUM_COMPRESSED"	"numeric"
"BT_ATTEMPTS"	"numeric"
"BT_CONNECTIONS"	"numeric"
"BT_DROPPED"	"numeric"
"BT_BYTES"	"numeric"
"PCF_GLITCHES"	"numeric"
"GSM_TX_NUMBER"	"numeric"
"BT_TX_NUMBER"	"numeric"
"TAG_TIME_STR"	"character"
"WD_FAIL_COUNT"	"numeric"
"TAG_OCLOCK_STR"	"character"
